aah	PRD_EXCL_BRDRLN
ab	PRD_EXCL_PRE
ae	PRD_EXCL
ag	PRD_EXCL
ai	PRD_EXCL
al	PRD_EXCL
alt	PRD_EXCL
ane	PRD_EXCL
ar	PRD_EXCL
arb	PRD_EXCL
asp	PRD_EXCL
auld	PRD_EXCL
ba	PRD_EXCL
bach	PRD_EXCL_PROPN
baht	PRD_EXCL
baize	PRD_EXCL
bal	PRD_EXCL
barbe	PRD_EXCL
barre	PRD_EXCL
bast	PRD_EXCL
bate	PRD_EXCL
batt	PRD_EXCL
beaux	PRD_EXCL_FRN
beck	PRD_EXCL_FRN
ben	PRD_EXCL_FRN
benne	PRD_EXCL
berg	PRD_EXCL
beth	PRD_EXCL
bey	PRD_EXCL
bi	PRD_EXCL_PRE
bibb	PRD_EXCL
bice	PRD_EXCL
bier	PRD_EXCL_FRN
biff	PRD_EXCL
birk	PRD_EXCL
birle	PRD_EXCL
birr	PRD_EXCL
bise	PRD_EXCL
blain	PRD_EXCL
blase	PRD_EXCL_FRN
blonde	PRD_EXCL_ALTSP
bo	PRD_EXCL
boart	PRD_EXCL
boche	PRD_EXCL_FRN
bock	PRD_EXCL
bonne	PRD_EXCL_FRN
boor	PRD_EXCL
borne	PRD_EXCL_ALTSP
borsch	PRD_EXCL
borscht	PRD_EXCL_FRN
bort	PRD_EXCL
bortz	PRD_EXCL
bosh	PRD_EXCL_FRN
bott	PRD_EXCL
boule	PRD_EXCL_FRN
bourg	PRD_EXCL_FRN
bourn	PRD_EXCL_ALTSP
bourne	PRD_EXCL_ALTSP
bourse	PRD_EXCL_FRN
bouse	PRD_EXCL
bowse	PRD_EXCL
brach	PRD_EXCL
brae	PRD_EXCL_FRN
brank	PRD_EXCL
brant	PRD_EXCL
bream	PRD_EXCL
brede	PRD_EXCL
bree	PRD_EXCL
breech	PRD_EXCL
bren	PRD_EXCL
brent	PRD_EXCL
brie	PRD_EXCL_FRN
brill	PRD_EXCL
brin	PRD_EXCL
britt	PRD_EXCL
brock	PRD_EXCL
brose	PRD_EXCL
brugh	PRD_EXCL
brut	PRD_EXCL
buhl	PRD_EXCL_FRN
buhr	PRD_EXCL_FRN
bund	PRD_EXCL_FRN
bunn	PRD_EXCL
bur	PRD_EXCL
burd	PRD_EXCL
burg	PRD_EXCL_FRN
burke	PRD_EXCL_FRN
burse	PRD_EXCL
buss	PRD_EXCL
bute	PRD_EXCL
cade	PRD_EXCL
cain	PRD_EXCL_PROPN
calk	PRD_EXCL_ALTSP
carl	PRD_EXCL_PROPN
carn	PRD_EXCL
carr	PRD_EXCL
carse	PRD_EXCL
carte	PRD_EXCL
cate	PRD_EXCL
caul	PRD_EXCL
celt	PRD_EXCL_FRN
cep	PRD_EXCL
chaise	PRD_EXCL_FRN
cham	PRD_EXCL
chang	PRD_EXCL_FRN
chao	PRD_EXCL_FRN
chasse	PRD_EXCL_FRN
chaw	PRD_EXCL
cheque	PRD_EXCL_ALTSP
chert	PRD_EXCL
chez	PRD_EXCL_FRN
chi	PRD_EXCL_FRN
childe	PRD_EXCL_ALTSP
chon	PRD_EXCL
chook	PRD_EXCL
ciao	PRD_EXCL_FRN
cinque	PRD_EXCL_FRN
cirque	PRD_EXCL_FRN
cist	PRD_EXCL
cleek	PRD_EXCL
clift	PRD_EXCL
cline	PRD_EXCL
clough	PRD_EXCL
cobb	PRD_EXCL
cod	PRD_EXCL_BRDRLN
cole	PRD_EXCL_PROPN
combe	PRD_EXCL_ALTSP
conch	PRD_EXCL_FISH
conn	PRD_EXCL
conte	PRD_EXCL_FRN
coombe	PRD_EXCL_FRN
cor	PRD_EXCL
corm	PRD_EXCL
corse	PRD_EXCL
coss	PRD_EXCL
cote	PRD_EXCL
coup	PRD_EXCL
cox	PRD_EXCL
coz	PRD_EXCL
creche	PRD_EXCL_FRN
cripe	PRD_EXCL
crosse	PRD_EXCL
crouse	PRD_EXCL
cruse	PRD_EXCL
cusk	PRD_EXCL
czar	PRD_EXCL_CBL
dace	PRD_EXCL
dag	PRD_EXCL
dahl	PRD_EXCL_PROPN
dais	PRD_EXCL
dak	PRD_EXCL
dal	PRD_EXCL
daube	PRD_EXCL_ALTSP
daw	PRD_EXCL
de	PRD_EXCL
deb	PRD_EXCL_PROPN
dee	PRD_EXCL
deet	PRD_EXCL
del	PRD_EXCL
delft	PRD_EXCL
dengue	PRD_EXCL_PROPN
dev	PRD_EXCL_ABBR
dex	PRD_EXCL
dey	PRD_EXCL
dhole	PRD_EXCL
dint	PRD_EXCL
dis	PRD_EXCL
doer	PRD_EXCL
doge	PRD_EXCL
dol	PRD_EXCL
dom	PRD_EXCL_FRN
donne	PRD_EXCL_FRN
dore	PRD_EXCL
dorr	PRD_EXCL
doss	PRD_EXCL
dost	PRD_EXCL_FRN
doth	PRD_EXCL_FRN
dow	PRD_EXCL
dower	PRD_EXCL
dray	PRD_EXCL
drogue	PRD_EXCL
drupe	PRD_EXCL
druse	PRD_EXCL
duce	PRD_EXCL_ALTSP
durn	PRD_EXCL
durr	PRD_EXCL
durst	PRD_EXCL
eau	PRD_EXCL_FRN
eaux	PRD_EXCL_FRN
eide	PRD_EXCL
el	PRD_EXCL
ell	PRD_EXCL
eng	PRD_EXCL
er	PRD_EXCL
erne	PRD_EXCL
ess	PRD_EXCL
et	PRD_EXCL_FRN
eyre	PRD_EXCL
fain	PRD_EXCL
fane	PRD_EXCL
fay	PRD_EXCL
feck	PRD_EXCL_FRN
femme	PRD_EXCL_FRN
fer	PRD_EXCL_FRN
fess	PRD_EXCL
fete	PRD_EXCL_FRM
fez	PRD_EXCL_FRN
fil	PRD_EXCL
firth	PRD_EXCL
fisc	PRD_EXCL_ABBR
fjeld	PRD_EXCL_FRN
fjord	PRD_EXCL_FRN
flak	PRD_EXCL
flam	PRD_EXCL
fleer	PRD_EXCL
floc	PRD_EXCL
forte	PRD_EXCL_ALTSP
foss	PRD_EXCL
fosse	PRD_EXCL
foy	PRD_EXCL
franc	PRD_EXCL_FRN
fremd	PRD_EXCL_FRN
frere	PRD_EXCL_FRN
frith	PRD_EXCL
fyke	PRD_EXCL
gad	PRD_EXCL
gae	PRD_EXCL
gaff	PRD_EXCL
gamp	PRD_EXCL
gan	PRD_EXCL
gar	PRD_EXCL
garth	PRD_EXCL_PROPN
gast	PRD_EXCL_FRN
gault	PRD_EXCL
geck	PRD_EXCL
geez	PRD_EXCL_OFF
gen	PRD_EXCL_ABBR
gest	PRD_EXCL
ghee	PRD_EXCL_FRN
gib	PRD_EXCL
girt	PRD_EXCL
giv	PRD_EXCL
glace	PRD_EXCL
goy	PRD_EXCL_FRN
graham	PRD_EXCL_PROPN
grebe	PRD_EXCL_FOWL
griff	PRD_EXCL
grille	PRD_EXCL
groat	PRD_EXCL_FRN
grosz	PRD_EXCL_FRN
grum	PRD_EXCL
gude	PRD_EXCL
gul	PRD_EXCL
gyp	PRD_EXCL_FRN
haaf	PRD_EXCL_FRN
haar	PRD_EXCL_FRN
hade	PRD_EXCL
haen	PRD_EXCL_FRN
haik	PRD_EXCL_FRN
hajj	PRD_EXCL_FRN
hake	PRD_EXCL
halm	PRD_EXCL
hance	PRD_EXCL
hao	PRD_EXCL
hap	PRD_EXCL
hast	PRD_EXCL_FRN
harl	PRD_EXCL
hart	PRD_EXCL
hath	PRD_EXCL
haugh	PRD_EXCL
haut	PRD_EXCL_FRN
haute	PRD_EXCL_FRN
haw	PRD_EXCL
hebe	PRD_EXCL_ABBR
heil	PRD_EXCL_FRN
hep	PRD_EXCL
herl	PRD_EXCL
herm	PRD_EXCL
hern	PRD_EXCL
heth	PRD_EXCL
hight	PRD_EXCL
hm	PRD_EXCL_SND
hmm	PRD_EXCL_SND
hoar	PRD_EXCL
hogg	PRD_EXCL_PROPN
hoke	PRD_EXCL
holm	PRD_EXCL
holt	PRD_EXCL_PROPN
hong	PRD_EXCL_FRN
horst	PRD_EXCL_PROPN
howe	PRD_EXCL_PROPN
howk	PRD_EXCL
hoy	PRD_EXCL
hoyle	PRD_EXCL
hun	PRD_EXCL_FRN
hurst	PRD_EXCL
hwan	PRD_EXCL_FRN
ich	PRD_EXCL_FRN
jake	PRD_EXCL_PROPN
jane	PRD_EXCL_PROPN
jee	PRD_EXCL
jeez	PRD_EXCL_OFF
jess	PRD_EXCL_PROPN
jill	PRD_EXCL_PROPN
jin	PRD_EXCL_FRN
jo	PRD_EXCL_PROPN
joe	PRD_EXCL_PROPN
john	PRD_EXCL_PROPN
joss	PRD_EXCL_PROPN
jun	PRD_EXCL
jus	PRD_EXCL
ka	PRD_EXCL
kail	PRD_EXCL
kain	PRD_EXCL_PROPN
kane	PRD_EXCL_PROPN
karn	PRD_EXCL
karst	PRD_EXCL_FRN
kat	PRD_EXCL_ALTSP
kay	PRD_EXCL_ALTSP
kea	PRD_EXCL
keck	PRD_EXCL
keef	PRD_EXCL
keir	PRD_EXCL
kemp	PRD_EXCL
kent	PRD_EXCL_PROPN
kerb	PRD_EXCL_ALTSP
khan	PRD_EXCL_FRN
khat	PRD_EXCL
kibbe	PRD_EXCL
kief	PRD_EXCL
kier	PRD_EXCL
kip	PRD_EXCL
kir	PRD_EXCL
kirk	PRD_EXCL_PROPN
kirn	PRD_EXCL
kirsch	PRD_EXCL
kist	PRD_EXCL
kludge	PRD_EXCL_CBL
kluge	PRD_EXCL
klutz	PRD_EXCL_CBL
kohl	PRD_EXCL
koss	PRD_EXCL
kraft	PRD_EXCL_PROPN
krill	PRD_EXCL_FISH
kroon	PRD_EXCL
kraut	PRD_EXCL_FRN
kvetch	PRD_EXCL_FRN
kyte	PRD_EXCL
lac	PRD_EXCL
lade	PRD_EXCL
laird	PRD_EXCL
lall	PRD_EXCL
lang	PRD_EXCL_ABBR
lar	PRD_EXCL
lat	PRD_EXCL_ABBR
lech	PRD_EXCL
leet	PRD_EXCL_ABBR
lehr	PRD_EXCL_FRN
lek	PRD_EXCL
leu	PRD_EXCL
lev	PRD_EXCL_PROPN
ley	PRD_EXCL
li	PRD_EXCL_PROPN
liang	PRD_EXCL_PROPN
lib	PRD_EXCL_ABBR
lich	PRD_EXCL
licht	PRD_EXCL_FRN
lief	PRD_EXCL_PROPN
lieu	PRD_EXCL_FRN
lin	PRD_EXCL
ling	PRD_EXCL_FRN
linn	PRD_EXCL_PROPN
loge	PRD_EXCL
longe	PRD_EXCL_ALTSP
loth	PRD_EXCL
lotte	PRD_EXCL
lough	PRD_EXCL
loup	PRD_EXCL_FRN
lour	PRD_EXCL
lowe	PRD_EXCL
lown	PRD_EXCL
luce	PRD_EXCL
luff	PRD_EXCL
lum	PRD_EXCL
lunt	PRD_EXCL
lutz	PRD_EXCL_PROPN
mabe	PRD_EXCL
mache	PRD_EXCL
mae	PRD_EXCL
mag	PRD_EXCL_ABBR
maile	PRD_EXCL_FRN
mair	PRD_EXCL
malm	PRD_EXCL_FRN
marc	PRD_EXCL_PROPN
marge	PRD_EXCL_PROPN
marque	PRD_EXCL_FRN
marse	PRD_EXCL
masse	PRD_EXCL
matt	PRD_EXCL_PROPN
maud	PRD_EXCL_PROPN
maund	PRD_EXCL
med	PRD_EXCL_ABBR
mel	PRD_EXCL_PROPN
mell	PRD_EXCL
merk	PRD_EXCL
merl	PRD_EXCL
merle	PRD_EXCL
meth	PRD_EXCL_ABBR
mi	PRD_EXCL
mib	PRD_EXCL
mick	PRD_EXCL
mig	PRD_EXCL
milch	PRD_EXCL
mille	PRD_EXCL
milt	PRD_EXCL
mim	PRD_EXCL
minke	PRD_EXCL
mir	PRD_EXCL
mo	PRD_EXCL
moke	PRD_EXCL
mol	PRD_EXCL
mon	PRD_EXCL
monde	PRD_EXCL_FRN
mor	PRD_EXCL
mort	PRD_EXCL
mosk	PRD_EXCL
mott	PRD_EXCL
motte	PRD_EXCL
mu	PRD_EXCL
mulct	PRD_EXCL
mumm	PRD_EXCL_PROPN
mun	PRD_EXCL
murr	PRD_EXCL
mutch	PRD_EXCL
myrrh	PRD_EXCL
na	PRD_EXCL
nam	PRD_EXCL
nance	PRD_EXCL_PROPN
narc	PRD_EXCL_ABBR
nard	PRD_EXCL
ne	PRD_EXCL
nee	PRD_EXCL
nene	PRD_EXCL
ness	PRD_EXCL
nett	PRD_EXCL
neve	PRD_EXCL_PROPN
nill	PRD_EXCL
noh	PRD_EXCL
nom	PRD_EXCL_FRN
nome	PRD_EXCL
non	PRD_EXCL_PRE
nth	PRD_EXCL
nu	PRD_EXCL
oeuvre	PRD_EXCL_FRN
op	PRD_EXCL_ABBR
ort	PRD_EXCL
ose	PRD_EXCL
pac	PRD_EXCL
pah	PRD_EXCL
paik	PRD_EXCL
parr	PRD_EXCL
pash	PRD_EXCL
peart	PRD_EXCL
pease	PRD_EXCL
pech	PRD_EXCL
perse	PRD_EXCL
phage	PRD_EXCL_ABBR
phi	PRD_EXCL_FRN
phut	PRD_EXCL_FRN
phyle	PRD_EXCL
pi	PRD_EXCL_FRN
plack	PRD_EXCL
plew	PRD_EXCL
plotz	PRD_EXCL
plough	PRD_EXCL
poh	PRD_EXCL
pointe	PRD_EXCL_ALTSP
pol	PRD_EXCL
pom	PRD_EXCL
ponce	PRD_EXCL_PROPN
poon	PRD_EXCL
pree	PRD_EXCL
prest	PRD_EXCL
prig	PRD_EXCL
prill	PRD_EXCL
pross	PRD_EXCL
prost	PRD_EXCL_PROPN
psi	PRD_EXCL_FRN
pugh	PRD_EXCL
pung	PRD_EXCL
pur	PRD_EXCL
puss	PRD_EXCL_VULGAR
putsch	PRD_EXCL_FRN
putz	PRD_EXCL_FRN
pye	PRD_EXCL
qua	PRD_EXCL
quai	PRD_EXCL
quale	PRD_EXCL
quant	PRD_EXCL_ABBR
quay	PRD_EXCL_ALTSP
quid	PRD_EXCL_FRN
quin	PRD_EXCL
quire	PRD_EXCL
quoth	PRD_EXCL
raff	PRD_EXCL
ralph	PRD_EXCL_PROPN
rance	PRD_EXCL
rand	PRD_EXCL_FRN
rase	PRD_EXCL
rath	PRD_EXCL
rathe	PRD_EXCL
rax	PRD_EXCL
re	PRD_EXCL
rec	PRD_EXCL
reck	PRD_EXCL
redd	PRD_EXCL_PROPN
ree	PRD_EXCL
reg	PRD_EXCL
reif	PRD_EXCL
rem	PRD_EXCL
rep	PRD_EXCL_ABBR
repp	PRD_EXCL
resh	PRD_EXCL
ret	PRD_EXCL
rex	PRD_EXCL_PROPN
rho	PRD_EXCL_FRN
riel	PRD_EXCL
rill	PRD_EXCL
roc	PRD_EXCL
rolf	PRD_EXCL_PROPN
rood	PRD_EXCL
roose	PRD_EXCL
roque	PRD_EXCL
routh	PRD_EXCL
roux	PRD_EXCL_FRN
ruck	PRD_EXCL
rudd	PRD_EXCL_PROPN
rusk	PRD_EXCL
ruth	PRD_EXCL_PROPN
sain	PRD_EXCL
sal	PRD_EXCL
sall	PRD_EXCL
samp	PRD_EXCL
sark	PRD_EXCL
saul	PRD_EXCL_PROPN
sault	PRD_EXCL
scad	PRD_EXCL
scape	PRD_EXCL
scarp	PRD_EXCL
schist	PRD_EXCL
schlep	PRD_EXCL_CBL
schlepp	PRD_EXCL_FRN
schtick	PRD_EXCL_CBL
schlock	PRD_EXCL_FRN
schmaltz	PRD_EXCL_FRN
schmalz	PRD_EXCL_FRN
schmooze	PRD_EXCL_CBL	
schmuck	PRD_EXCL_FRN
schnook	PRD_EXCL_FRN
schul	PRD_EXCL_FRN
scot	PRD_EXCL_PROPN
scrod	PRD_EXCL_FISH
scud	PRD_EXCL
sec	PRD_EXCL
sedge	PRD_EXCL
seel	PRD_EXCL
segue	PRD_EXCL
seif	PRD_EXCL
seine	PRD_EXCL_PROPN
sel	PRD_EXCL
selle	PRD_EXCL
sen	PRD_EXCL
sere	PRD_EXCL
serge	PRD_EXCL
sha	PRD_EXCL
shad	PRD_EXCL_FISH
shaul	PRD_EXCL
shawn	PRD_EXCL_PROPN
shay	PRD_EXCL
shea	PRD_EXCL_PROPN
sheikh	PRD_EXCL_FRN
shew	PRD_EXCL
shiel	PRD_EXCL
shirr	PRD_EXCL
shive	PRD_EXCL
shlock	PRD_EXCL_CBL
shoppe	PRD_EXCL_ALTSP
shott	PRD_EXCL_PROPN
shri	PRD_EXCL_FRN
shroff	PRD_EXCL
shtick	PRD_EXCL
shute	PRD_EXCL
si	PRD_EXCL
sib	PRD_EXCL
sic	PRD_EXCL
sim	PRD_EXCL_ABBR
sipe	PRD_EXCL
skeen	PRD_EXCL
skein	PRD_EXCL
skene	PRD_EXCL
skoal	PRD_EXCL_PROPN
sloe	PRD_EXCL
smit	PRD_EXCL_PROPN
snell	PRD_EXCL
soave	PRD_EXCL
souk	PRD_EXCL
sous	PRD_EXCL_FRN
spake	PRD_EXCL
spall	PRD_EXCL
spang	PRD_EXCL
spec	PRD_EXCL_ABBR
speer	PRD_EXCL_PROPN
speir	PRD_EXCL_PROPN
speltz	PRD_EXCL_FRN
spence	PRD_EXCL
sphinx	PRD_EXCL_PROPN
spurge	PRD_EXCL
sri	PRD_EXCL
stade	PRD_EXCL
staph	PRD_EXCL
stat	PRD_EXCL_ABBR
stet	PRD_EXCL
stipe	PRD_EXCL
stoup	PRD_EXCL
strang	PRD_EXCL
strep	PRD_EXCL
strew	PRD_EXCL
strick	PRD_EXCL
stroud	PRD_EXCL
strow	PRD_EXCL
stull	PRD_EXCL
stum	PRD_EXCL
sudd	PRD_EXCL
sward	PRD_EXCL
swart	PRD_EXCL
swink	PRD_EXCL
sylph	PRD_EXCL
syn	PRD_EXCL
tae	PRD_EXCL
taj	PRD_EXCL
tam	PRD_EXCL
tao	PRD_EXCL_FRN
tass	PRD_EXCL
tat	PRD_EXCL
tate	PRD_EXCL_PROPN
ted	PRD_EXCL_PROPN
tel	PRD_EXCL_ABBR
tench	PRD_EXCL
tern	PRD_EXCL_FOWL
tet	PRD_EXCL
tew	PRD_EXCL
thane	PRD_EXCL
thein	PRD_EXCL
therm	PRD_EXCL
thew	PRD_EXCL
thill	PRD_EXCL
tho	PRD_EXCL
thole	PRD_EXCL
thorp	PRD_EXCL
thorpe	PRD_EXCL_PROPN
throve	PRD_EXCL
thrush	PRD_EXCL_FOWL
ti	PRD_EXCL
tierce	PRD_EXCL
tilth	PRD_EXCL
ting	PRD_EXCL
tod	PRD_EXCL
toff	PRD_EXCL
toft	PRD_EXCL
tole	PRD_EXCL
tonne	PRD_EXCL_ALTSP
tope	PRD_EXCL
tor	PRD_EXCL
torr	PRD_EXCL
tosh	PRD_EXCL
touche	PRD_EXCL_FRN
treen	PRD_EXCL
trey	PRD_EXCL
trice	PRD_EXCL
trie	PRD_EXCL
trig	PRD_EXCL_ABBR
trine	PRD_EXCL
troche	PRD_EXCL
trone	PRD_EXCL
troth	PRD_EXCL
trow	PRD_EXCL
troy	PRD_EXCL_PROPN
trull	PRD_EXCL
trying	PRD_EXCL
tung	PRD_EXCL
turk	PRD_EXCL_PROPN
twain	PRD_EXCL
tye	PRD_EXCL
tyne	PRD_EXCL
umm	PRD_EXCL
un	PRD_EXCL
vail	PRD_EXCL_PROPN
vang	PRD_EXCL
vee	PRD_EXCL
veep	PRD_EXCL_ABBR
vert	PRD_EXCL
vide	PRD_EXCL
vive	PRD_EXCL_FRN
vox	PRD_EXCL_FRN
vroom	PRD_EXCL
wack	PRD_EXCL_ALTSP
wark	PRD_EXCL
wat	PRD_EXCL
waugh	PRD_EXCL
wecht	PRD_EXCL
wen	PRD_EXCL_FRN
wert	PRD_EXCL
whang	PRD_EXCL_ALTSP
whig	PRD_EXCL_ALTSP
whit	PRD_EXCL
wich	PRD_EXCL
wiss	PRD_EXCL
wist	PRD_EXCL
withe	PRD_EXCL
wo	PRD_EXCL
wold	PRD_EXCL
wop	PRD_EXCL
wren	PRD_EXCL_FOWL
wye	PRD_EXCL
wyle	PRD_EXCL_PROPN
wynn	PRD_EXCL_PROPN
xi	PRD_EXCL_FRN
xu	PRD_EXCL_FRN
ya	PRD_EXCL
yah	PRD_EXCL
yang	PRD_EXCL_FRN
ye	PRD_EXCL
yeh	PRD_EXCL
yett	PRD_EXCL
yew	PRD_EXCL_TREE
yin	PRD_EXCL
yom	PRD_EXCL
youse	PRD_EXCL
zed	PRD_EXCL_FRN
zee	PRD_EXCL
zill	PRD_EXCL
zine	PRD_EXCL